1111111111110
10010000S00C1
1000011011001
1P0011E00P001
111111111111
